001000100001111111,
101110101101111111,
101110101101111111,
101110101101111111,
101110101101111111,
101110101101111111,
100110001100000000,
111111111111111111